1111111111111111111111111111111111
1111111000000011111111111111111111
11000000111110000000000000C0000001
1111111111111111111111111111111101
11E0001111111111111111111111111101
1111011111111111110000C00000000001
1111011111111111110111111111111111
11110111111111111101100PCCC0011111
1111011110000000000110111111011111
1111011110111111111110111111011111
1111011110000000000000111111011111
1111011111111111111111111111011111
1111011111111000C00000000000011111
1111011111111011111111111111111111
1111011111111011111111111111111111
1111C11111111011111111111111111111
1111011111111011111111111111111111
1111011111111011111111111111111111
1111011111111011111111111111111111
1111000000000011111111111111111111
1111111111111111111111111111111111
