11111111111
111111111C1
1100C0ECC11
100000111C1
11111111111
