1111111111
1PCCCC11E1
1110111001
1000101011
1010111011
1000000011
1011101111
1010000001
1111111111
